 8 6  3  0  3  6 8
8        *
        * *
6       * * 
       *   * 
 *     *   *     *
3***  *     *  ***
 *  ***     ***  *
  *             *
0  *           *
   *           *
    *         *
3   *    *    *
    *   * *   *
   *   *   *   *
6  * **     ** *
  * *         * *
8 **           **
 